0001000002000000000000000
0000000000000200000000000
0000002000000000100000000
0000030000000000000000000
0000000000200000003004000
0001000000000001000000000
0004000000000000000000000
0000000030002000100000000
0000000000400000000000000
0001000000000020000000000
0000000000030000000000000
0000010000000010000000000
0000000000000000000000000
0000000400040000000000000
0000010000000002003000000
0000001000000000000000000
0000000000000500000010000
0000300000005000000000000
0002000000000000000300000
0000040000001000000000000
0000000000000000020000000
0001000000000000000050000
0000000000010000100000000
0000000000000000000000000
0000000500000000000011000
